border_size=1
usage=map

Wo          , Wo          , Wo          , Wo          , Wo          , Wo          , Wo          , Wo          , Wo          , Wo          , Wo          , Wo          , Wo          , Wo          , Wo          , Wo          , Wo          , Wo          , Wo          , Wo          , Wo          , Wo          , Wo          , Wo          , Wo          , Wo          , Wo          , Wo          , Wo          , Wo          , Wo          , Wo          , Wo          , Wo          , Wo          , Wo          , Wo          , Wo          , Wo          
Wo          , Wo          , Wo          , Wo          , Wo          , Wo          , Wo          , Wo          , Wo          , Wo          , Wo          , Wo          , Wo          , Wo          , Wo          , Wo          , Wo          , Wo          , Wo          , Wo          , Wo          , Wo          , Wo          , Wo          , Wo          , Wo          , Wo          , Wo          , Wo          , Wo          , Wo          , Wo          , Wo          , Wo          , Wo          , Wo          , Wo          , Wo          , Wo          
Wo          , Wo          , Wo          , Wo          , Wo          , Wo          , Wo          , Wo          , Wo          , Wo          , Wo          , Wo          , Wo          , Wo          , Wo          , Wo          , Wo          , Wo          , Wo          , Wo          , Wo          , Wo          , Wo          , Wo          , Wo          , Wo          , Ww          , Wo          , Ww          , Wo          , Ww          , Wo          , Ww          , Wo          , Wo          , Wo          , Wo          , Wo          , Wo          
Wo          , Wo          , Wo          , Wo          , Wwr         , Wo          , Ww          , Wwr         , Ww          , Wo          , Ww          , Wo          , Wo          , Wo          , Wo          , Wo          , Wo          , Wo          , Wo          , Wo          , Wo          , Wo          , Wo          , Ww          , Ww          , Ww          , Dd          , Ww          , Dd          , Ww          , Dd          , Ww          , Ww          , Wo          , Wo          , Wo          , Wo          , Wo          , Wo          
Wo          , Wo          , Wo          , Wo          , Ww          , Ww          , Dd          , Ww          , Dd          , Ww          , Wwr         , Ww          , Ww          , Wo          , Wo          , Wo          , Wo          , Wo          , Wo          , Wo          , Ww          , Wo          , Ww          , Ww          , Dd          , Dd          , Gs^Ft       , Dd          , Gs^Ft       , Dd          , Gs^Ft       , Dd          , Ww          , Wo          , Wo          , Wo          , Wo          , Wo          , Wo          
Wo          , Wo          , Wo          , Wo          , Ww          , Dd          , Gg^Ve       , Dd          , Gs^Fp       , Dd          , Dd          , Dd          , Dd          , Ww          , Ww          , Wo          , Wo          , Wo          , Wo          , Wo          , Ww          , Ww          , Dd          , Dd          , Hh          , Gs          , Hh          , Gs^Ft       , Gs          , Gs^Ft       , Gs^Ft       , Dd          , Ww          , Wo          , Wo          , Wo          , Wo          , Wo          , Wo          
Wo          , Wo          , Wo          , Wwr         , Ww          , Dd          , Gs^Fp       , Gs^Fp       , Gs^Fp       , Gs^Fp       , Gs^Fp       , Gg^Ve       , Gg          , Dd          , Dd          , Ww          , Ww          , Wo          , Ww          , Ww          , Dd          , Dd          , Gs^Ft       , Hh          , Gs          , Hh          , Mm          , Hh          , Hh          , Gs          , Dd          , Dd          , Ww          , Wo          , Wo          , Wo          , Wo          , Wo          , Wo          
Wo          , Wo          , Wo          , Wo          , Ww          , Wwr         , Dd          , Gs^Fp       , Gg^Ve       , Gs^Fp       , Gs^Fp       , Gs^Fp       , Hh          , Gg          , Dd          , Ww          , Ww          , Wo          , Ww          , Dd          , Gs^Ft       , Gs^Ft       , Gs^Ft       , Gs^Ft       , Gs^Ft       , Hh          , Hh          , Mm          , Hh          , Gs          , Dd          , Wwr         , Ww          , Wo          , Wo          , Wo          , Wo          , Wo          , Wo          
Wo          , Wo          , Wo          , Wo          , Ww          , Ww          , Dd          , Hh          , Hh          , Gg          , Hh          , Gs^Fp       , Hh          , Gg          , Gs          , Dd          , Dd          , Ww          , Ww          , Dd          , Gs^Ft       , Hh          , Gs          , Hh          , Hh          , Gs^Ft       , Hh          , Hh          , Gs          , Gs          , Gs          , Dd          , Ww          , Ww          , Wo          , Wo          , Wo          , Wo          , Wo          
Wo          , Wo          , Wo          , Wo          , Wo          , Ww          , Ww          , Dd          , Hh          , Gg          , Hh          , Hh          , Hh          , Gg          , Gs^Vht      , Gs          , Dd          , Ww          , Ww          , Dd          , Dd          , Gs          , Dd          , Dd          , Dd          , Gs          , Gs          , Gs          , Hh          , Hh          , Gs^Ft       , Dd          , Dd          , Ww          , Ww          , Wo          , Wo          , Wo          , Wo          
Wo          , Wo          , Wo          , Wo          , Wo          , Ww          , Ww          , Dd          , Dd          , Hh          , Mm          , Hh          , Hh          , Gs^Ft       , Hh          , Gs^Ft       , Gg          , Dd          , Ww          , Ww          , Ww          , Dd          , Ww          , Wwr         , Ww          , Dd          , Dd          , Gs          , Hh          , Mm          , Hh          , Gs^Ft       , Dd          , Wwr         , Ww          , Wo          , Wo          , Wo          , Wo          
Wo          , Wo          , Wo          , Wo          , Wo          , Wo          , Ww          , Ww          , Dd          , Hh          , Hh          , Mm          , Hh          , Hh          , Gs^Ft       , Gs^Ft       , Gs^Ft       , Dd          , Dd          , Ww          , Ww          , Ww          , Wo          , Wo          , Wo          , Ww          , Wwr         , Dd          , Gs          , Hh          , Mm          , Hh          , Gs          , Dd          , Ww          , Wo          , Wo          , Wo          , Wo          
Wo          , Wo          , Wo          , Wo          , Wo          , Wo          , Ww          , Dd          , Gg          , Gg          , Gs^Ft       , Mm          , Mm          , Gs          , Gs          , Gs^Ft       , Gs          , Gs          , Dd          , Ww          , Ww          , Wo          , Wo          , Wo          , Wo          , Ww          , Dd          , Dd          , Gs          , Hh          , Hh          , Hh          , Gs          , Dd          , Ww          , Wo          , Wo          , Wo          , Wo          
Wo          , Wo          , Wo          , Wo          , Wo          , Ww          , Dd          , Dd          , Hh          , Gs^Ft       , Gs^Ft       , Mm^Vhh      , Hh          , Hh          , Gs          , Gs          , Gs          , Gs          , Gs          , Dd          , Wwr         , Ww          , Ww          , Wo          , Ww          , Ww          , Dd          , Gs          , Gs          , Gs          , Ce          , Gs          , Gs          , Dd          , Ww          , Ww          , Wo          , Wo          , Wo          
Wo          , Wo          , Wo          , Wo          , Wo          , Ww          , Dd          , Gs          , Hh          , Hh          , Gs^Ft       , Gs^Ft       , Gs          , Gs          , Ce          , Gs          , Gs          , Gs          , Gs          , Dd          , Dd          , Dd          , Dd          , Ww          , Dd          , Dd          , Gs          , Gs          , Gs          , Ce          , Ce          , 1 Ke        , Gs          , Dd          , Ww          , Ww          , Wo          , Wo          , Wo          
Wo          , Wo          , Wo          , Wo          , Wo          , Ww          , Dd          , Gs          , Gs^Ft       , Hh          , Gs^Ft       , Gs          , Gs          , 2 Ke        , Ce          , Ce          , Gs          , Gs          , Gs^Ft       , Gs^Ft       , Gs^Ft       , Gs^Ft       , Dd          , Ww          , Dd          , Gs          , Gs^Ft       , Gs          , Hh          , Gs          , Gs          , Gs          , Gs          , Dd          , Ww          , Wo          , Wo          , Wo          , Wo          
Wo          , Wo          , Wo          , Wo          , Wo          , Ww          , Dd          , Gs          , Gs^Ft       , Gs^Ft       , Gs^Ft       , Hh          , Hh          , Gs          , Gs          , Gs          , Gs          , Gs^Ft       , Gs          , Gs^Ft       , Dd          , Dd          , Ww          , Ww          , Ww          , Dd          , Gs^Ft       , Gs^Ft       , Gs^Ft       , Hh          , Hh          , Hh          , Dd          , Dd          , Ww          , Wo          , Wo          , Wo          , Wo          
Wo          , Wo          , Wo          , Wo          , Wo          , Ww          , Dd          , Gs^Vht      , Dd          , Gs^Ft       , Gs          , Hh          , Dd          , Hh          , Gs^Vht      , Gs          , Gs^Ft       , Gs^Ft       , Dd          , Dd          , Ww          , Ww          , Wo          , Ww          , Ww          , Dd          , Dd          , Gs^Ft       , Dd          , Hh          , Dd          , Gs          , Dd          , Wwr         , Ww          , Wo          , Wo          , Wo          , Wo          
Wo          , Wo          , Wo          , Wo          , Wo          , Ww          , Ww          , Dd          , Wwr         , Dd          , Dd          , Dd          , Ww          , Dd          , Dd          , Dd          , Dd          , Gs^Ft       , Dd          , Wwr         , Ww          , Wo          , Wo          , Wo          , Wo          , Ww          , Ww          , Dd          , Ww          , Dd          , Ww          , Dd          , Ww          , Ww          , Wo          , Wo          , Wo          , Wo          , Wo          
Wo          , Wo          , Wo          , Wo          , Wo          , Wo          , Wo          , Ww          , Ww          , Ww          , Ww          , Ww          , Ww          , Ww          , Ww          , Wwr         , Ww          , Dd          , Ww          , Ww          , Wo          , Wo          , Wo          , Wo          , Wo          , Wo          , Wo          , Ww          , Wo          , Ww          , Wo          , Ww          , Wo          , Wo          , Wo          , Wo          , Wo          , Wo          , Wo          
Wo          , Wo          , Wo          , Wo          , Wo          , Wo          , Wo          , Wo          , Wo          , Wo          , Wo          , Wo          , Wo          , Wo          , Wo          , Ww          , Ww          , Ww          , Wo          , Wo          , Wo          , Wo          , Wo          , Wo          , Wo          , Wo          , Wo          , Wo          , Wo          , Wo          , Wo          , Wo          , Wo          , Wo          , Wo          , Wo          , Wo          , Wo          , Wo          
Wo          , Wo          , Wo          , Wo          , Wo          , Wo          , Wo          , Wo          , Wo          , Wo          , Wo          , Wo          , Wo          , Wo          , Wo          , Wo          , Wo          , Wo          , Wo          , Wo          , Wo          , Wo          , Wo          , Wo          , Wo          , Wo          , Wo          , Wo          , Wo          , Wo          , Wo          , Wo          , Wo          , Wo          , Wo          , Wo          , Wo          , Wo          , Wo          
Wo          , Wo          , Wo          , Wo          , Wo          , Wo          , Wo          , Wo          , Wo          , Wo          , Wo          , Wo          , Wo          , Wo          , Wo          , Wo          , Wo          , Wo          , Wo          , Wo          , Wo          , Wo          , Wo          , Wo          , Wo          , Wo          , Wo          , Wo          , Wo          , Wo          , Wo          , Wo          , Wo          , Wo          , Wo          , Wo          , Wo          , Wo          , Wo          
Wo          , Wo          , Wo          , Wo          , Wo          , Wo          , Wo          , Wo          , Wo          , Wo          , Wo          , Wo          , Wo          , Wo          , Wo          , Wo          , Wo          , Wo          , Wo          , Wo          , Wo          , Wo          , Wo          , Wo          , Wo          , Wo          , Wo          , Wo          , Wo          , Wo          , Wo          , Wo          , Wo          , Wo          , Wo          , Wo          , Wo          , Wo          , Wo          
