border_size=1
usage=map

Wo          , Wo          , Wo          , Wo          , Wo          , Wo          , Wo          , Wo          , Wo          , Wo          , Gs^Ft       , Wo          , Wo          , Wo          , Gs^Ft       , Wo          , Wo          , Wo          , Wo          , Wo          , Wo          , Wo          , Wo          , Wo          , Wo          , Wo          , Wo          
Wo          , Wo          , Wo          , Wo          , Wo          , Wo          , Ww          , Ww          , Wwr         , Ww          , Gs^Ft       , Ww          , Ww          , Ww          , Gs^Ft       , Wo          , Wo          , Wo          , Wo          , Wo          , Wo          , Wo          , Wo          , Wo          , Wo          , Wo          , Wo          
Wo          , Wo          , Wo          , Wo          , Wo          , Ww          , Ww          , Gs^Ft       , Hh          , Gs^Ft       , Gs^Ft       , Gs^Ft       , Wwr         , Gs^Ft       , Wo          , Wo          , Wo          , Wo          , Wo          , Wo          , Wo          , Wo          , Wo          , Wo          , Wo          , Wo          , Wo          
Wo          , Wo          , Wo          , Wo          , Ww          , Ww          , Gs^Ft       , Hh          , Mm          , Wwr         , Gs^Ft       , Gs^Ft       , Hh          , Gs^Ft       , Ww          , Wo          , Wo          , Wo          , Wo          , Wo          , Wo          , Wo          , Wo          , Wo          , Wo          , Wo          , Wo          
Wo          , Wo          , Wo          , Wo          , Ww          , Ww          , Ds          , Mm          , Ql          , Gs^Ft       , Gs^Ft       , Hh          , Hh          , Gs^Ft       , Wwr         , Ww          , Wo          , Wo          , Wo          , Wo          , Wo          , Wo          , Wo          , Wo          , Wo          , Wo          , Wo          
Wo          , Wo          , Ww          , Ww          , Ww          , Ww          , Gs^Ft       , Mm^Vhh      , Mm          , Gs^Ft       , Gs^Ft       , Gs^Ft       , Mm          , Gs^Ft       , Gs^Ft       , Ww          , Wo          , Wo          , Wo          , Wo          , Wo          , Wo          , Wo          , Wo          , Wo          , Wo          , Wo          
Wo          , Wo          , Ww          , Ww          , Wwr         , Ww          , Ww          , Gs^Ft       , Hh          , Gs^Ft       , Gs^Ft       , Gs^Ft       , Hh^Vhh      , Ds          , Ww          , Ww          , Wo          , Wo          , Wo          , Wo          , Wo          , Wo          , Wo          , Wo          , Wo          , Wo          , Wo          
Wo          , Ww          , Ww          , Gs^Ft       , Gs^Ft       , Ds          , Gs^Vht      , Gs          , Gs          , Gs^Ft       , Gs^Ft       , Hh          , Gs^Ft       , Gs^Ft       , Ww          , Ww          , Wo          , Wo          , Wo          , Wo          , Wo          , Wo          , Wo          , Wo          , Wo          , Wo          , Wo          
Wo          , Ww          , Ww          , Ww          , Ww          , Hh          , Hh          , Gs          , Gs          , Gs          , Hh          , Hh          , Gs^Ft       , Ww          , Ww          , Ww          , Ww          , Ww          , Ww          , Ww          , Wo          , Wo          , Wo          , Wo          , Wo          , Wo          , Wo          
Wo          , Wo          , Ww          , Ww          , Ww          , Ww          , Ww          , Hh          , Gs          , Gs          , Gs^Vht      , Gs^Ft       , Hh          , Gs^Ft       , Ww          , Ww          , Ww          , Gs^Ft       , Gs^Ft       , Ww          , Ww          , Wo          , Wo          , Wo          , Wo          , Wo          , Wo          
Wo          , Wo          , Wo          , Ww          , Ww          , Ww          , Ww          , Ww          , Gs^Ft       , Gs          , Ww          , Gs^Ft       , Ce          , Hh          , Gs^Ft       , Ww          , Ww          , Ww          , Ww          , Ww          , Wo          , Wo          , Ww          , Ww          , Ww          , Wo          , Wo          
Wo          , Wo          , Wo          , Wo          , Wo          , Ww          , Ww          , Ww          , Wwr         , Ww          , Ww          , Ww          , Ww          , Ce          , Mm          , Ww          , Gs^Ft       , Ww          , Ww          , Ww          , Wo          , Wo          , Ww          , Gs^Ft       , Gs^Ft       , Wo          , Wo          
Wo          , Wo          , Wo          , Wo          , Wo          , Ww          , Ww          , Ww          , Gs^Vht      , Ww          , Ww          , Ww          , Ww          , 2 Ke        , Ce          , Mm          , Hh          , Gs^Ft       , Gs^Ft       , Ww          , Ww          , Ww          , Ww          , Ww          , Gs^Ft       , Wo          , Wo          
Wo          , Wo          , Wo          , Wo          , Wo          , Ww          , Ww          , Gs^Ft       , Ww          , Gs^Ft       , Gs^Ft       , Ww          , Ww          , Ce          , Gs^Ft       , Gs^Ft       , Ww          , Hh          , Gs^Vht      , Ww          , Ww          , Ww          , Gs^Ft       , Wwr         , Ww          , Ww          , Wo          
Wo          , Wo          , Wo          , Wo          , Ww          , Ww          , Ww          , Gs^Ft       , Ds          , Ww          , Gs^Ft       , Gs^Ft       , Gs^Ft       , Gs^Ft       , Gs^Ft       , Wwr         , Ww          , Gs^Ft       , Gs^Ft       , Ww          , Gs^Ft       , Gs^Ft       , Ww          , Ww          , Wo          , Wo          , Wo          
Wo          , Wo          , Wo          , Wo          , Ww          , Ww          , Wwr         , Ww          , Ww          , Gs^Vht      , Wwr         , Gs^Ft       , Gs^Ft       , Ww          , Ww          , Gs^Ft       , Ww          , Ww          , Ds          , Hh          , Gs^Vht      , Ww          , Ww          , Wo          , Wo          , Wo          , Wo          
Wo          , Wo          , Wo          , Ww          , Ww          , Ww          , Ww          , Ww          , Ww          , Ww          , Ww          , Ww          , Gs^Ft       , Ww          , Wwr         , Gs^Ft       , Ww          , Ww          , Ww          , Gs^Ft       , Gs^Ft       , Ww          , Wo          , Wo          , Wo          , Wo          , Wo          
Wo          , Wo          , Wo          , Ww          , Ww          , Gs^Ft       , Hh          , Gs^Vht      , Gs^Ft       , Ww          , Ww          , Ww          , Ww          , Gs^Ft       , Ww          , Ww          , Wo          , Wo          , Wo          , Ww          , Wwr         , Ww          , Ww          , Wo          , Wo          , Wo          , Wo          
Wo          , Wo          , Ww          , Ww          , Ww          , Ww          , Hh          , Gs^Ft       , Gs^Ft       , Gs^Ft       , Wwr         , Ww          , Ww          , Ww          , Ww          , Ww          , Ww^Vm       , Ww          , Ww          , Ww          , Gs^Ft       , Ww          , Hh          , Ww          , Ww          , Wo          , Wo          
Wo          , Wo          , Ww          , Wwr         , Ww          , Ww          , Mm          , Hh          , Hh          , Gs^Ft       , Wwf         , Ww          , Ww          , Ww          , Gs^Ft       , Wwr         , Ww          , Ww          , Ww          , Gs^Ft       , Gs^Ft       , Gs^Ft       , Hh          , Gs^Vht      , Gs^Ft       , Ww          , Wo          
Wo          , Ww          , Ww          , Ww          , Wwf         , Ww          , Wwr         , Mm          , Hh          , Gs^Vht      , Ww          , Wwf         , Wwf         , Gs^Ft       , Gs^Ft       , Gs^Ft       , Ww          , Ww          , Wo          , Ww          , Ww          , Gs^Ft       , Gs^Ft       , Hh          , Ww          , Wo          , Wo          
Wo          , Ww          , Gs^Ft       , Ww          , Ww          , Wwf         , Ww          , Mm          , Ww          , Ww          , Ww          , Ww          , Wwf         , Wwf         , Ww          , Gs^Vht      , Wwr         , Ww          , Ww          , Wo          , Ww          , Gs^Vht      , Gs^Ft       , Wwr         , Ww          , Wo          , Wo          
Wo          , Wo          , Gs^Ft       , Wwr         , Gs^Ft       , Wwf         , Ww          , Ww          , Ww^Vm       , Ww          , Ww          , Gs^Vht      , Wwf         , Ww          , Ww          , Ww          , Ww          , Gs^Ft       , Gs^Ft       , Ww          , Ds          , Gs^Ft       , Hh          , Hh          , Ww          , Wo          , Wo          
Wo          , Wo          , Ww          , Ww          , Gs^Ft       , Wwf         , Wwf         , Ww          , Ww          , Ww          , Ww          , Gs^Ft       , Ww          , Wwf         , Wwf         , Ww          , Ww          , Ww          , Gs^Ft       , Gs^Ft       , Gs^Ft       , Gs^Ft       , Gs^Vht      , Ww          , Wo          , Wo          , Wo          
Wo          , Wo          , Wo          , Ww          , Wwf         , Gs^Ft       , Ww          , Wwf         , Wwf         , Ww          , Wwf         , Ww          , Ww          , Ww          , Gs^Ft       , Ww          , Ww          , Ww          , Wwf         , Gs^Ft       , Gs^Ft       , Ww          , Gs^Ft       , Ww          , Wo          , Wo          , Wo          
Wo          , Wo          , Wo          , Ww          , Ww          , Wwf         , Wwf         , Wwf         , Gs^Ft       , Wwf         , Wwf         , Ww          , Hh          , Gs^Vht      , Gs^Ft       , Gs^Vht      , Gs^Ft       , Ww          , Ww          , Wwf         , Gs^Ft       , Ww          , Gs^Ft       , Ww          , Ww          , Wo          , Wo          
Wo          , Wo          , Ww          , Wwf         , Ww          , Ww          , Gs^Ft       , Gs^Ft       , Gs^Vht      , Ww          , Ww          , Wwf         , Wwf         , Hh          , Ce          , Gs^Ft       , Ce          , Wwf         , Wwf         , Wwf         , Ww          , Wwr         , Ww          , Ww          , Wo          , Wo          , Wo          
Wo          , Wo          , Wwf         , Wwf         , Ww          , Wwr         , Hh          , Hh          , Gs^Ft       , Ww          , Wwf         , Ww          , Ww          , Ce          , 1 Ke        , Ce          , Ww          , Ww          , Ww          , Ww          , Ww          , Ww          , Ww          , Wo          , Wo          , Wo          , Wo          
Wo          , Wo          , Wwf         , Ww          , Ww          , Ds          , Hh          , Hh          , Ww          , Ww          , Wwf         , Ww          , Ww          , Ww          , Ww          , Wwf         , Wwf         , Ww          , Wwf         , Wwf         , Wwf         , Ww          , Ww          , Ww          , Ww          , Wo          , Wo          
Wo          , Ww          , Wwf         , Ww          , Gs^Ft       , Hh          , Hh          , Gs^Ft       , Wwr         , Ww          , Ww          , Ww          , Ww          , Ww          , Gs^Vht      , Gs^Ft       , Gs^Ft       , Wwf         , Gs^Ft       , Gs^Ft       , Wwf         , Ww          , Ww          , Gs^Ft       , Wo          , Wo          , Wo          
Wo          , Ww          , Ww          , Wwr         , Hh          , Hh          , Ds          , Ww          , Ww          , Wwf         , Ww          , Ww          , Ww          , Ww          , Gs^Ft       , Gs^Ft       , Ww          , Wwr         , Gs^Ft       , Gs^Vht      , Ww          , Ww          , Ww          , Wwr         , Ww          , Wo          , Wo          
Wo          , Wo          , Wo          , Gs^Ft       , Hh          , Hh          , Wwr         , Ww          , Wwf         , Wwf         , Ww          , Ww          , Hh          , Gs^Ft       , Gs^Ft       , Ds          , Ww          , Ww          , Gs^Ft       , Ww          , Gs^Ft       , Ww          , Wwf         , Wwf         , Gs^Ft       , Wo          , Wo          
Wo          , Wo          , Gs^Ft       , Gs^Ft       , Hh          , Gs^Vht      , Ww          , Wwf         , Ww          , Ww          , Ww          , Hh          , Ww          , Hh          , Hh          , Ww          , Ww          , Ww          , Ww          , Wwr         , Ww          , Wwr         , Wwf         , Gs^Ft       , Gs^Vht      , Ww          , Wo          
Wo          , Ww          , Hh          , Hh          , Gs^Ft       , Ww          , Ww          , Ww          , Ww          , Ww          , Wwf         , Wwr         , Ww          , Ww          , Hh          , Gs^Vht      , Ww          , Ww          , Wo          , Ww          , Ww          , Ww          , Wwr         , Ww          , Gs^Ft       , Wo          , Wo          
Wo          , Ww          , Ww          , Gs^Ft       , Ww          , Ww          , Wwf         , Ww          , Ww^Vm       , Ww          , Ww          , Wwf         , Wwf         , Ww          , Wwr         , Hh          , Ww          , Wo          , Wo          , Wo          , Ww          , Ww          , Gs^Ft       , Ww          , Gs^Ft       , Wo          , Wo          
Wo          , Wo          , Wo          , Wwf         , Wwf         , Wwf         , Ww          , Ww          , Ww          , Ww          , Ww          , Ww          , Ww          , Wwf         , Ww          , Ww          , Ww          , Ww          , Ww          , Ww          , Gs^Ft       , Gs^Ft       , Gs^Ft       , Wwr         , Gs^Ft       , Wo          , Ww          
Wo          , Wo          , Wo          , Ww          , Wo          , Ww          , Wo          , Wo          , Wo          , Wo          , Ww          , Ww          , Gs^Ft       , Wwr         , Ww          , Ww          , Gs^Ft       , Ww          , Gs^Vht      , Ds          , Gs^Ft       , Gs^Ft       , Hh          , Hh          , Ww          , Ww          , Wo          
Wo          , Wo          , Wo          , Wo          , Wo          , Wo          , Wo          , Wo          , Ww          , Wo          , Ww          , Gs^Ft       , Gs^Ft       , Gs^Vht      , Ww          , Gs^Ft       , Ww          , Gs^Ft       , Gs^Ft       , Gs^Ft       , Gs^Ft       , Hh^Vhh      , Mm          , Gs^Ft       , Gs^Ft       , Wo          , Wo          
Wo          , Wo          , Wo          , Wo          , Wo          , Wo          , Wo          , Wo          , Wwf         , Wwf         , Wwr         , Gs^Ft       , Gs^Ft       , Gs^Ft       , Gs^Ft       , Ww          , Gs^Ft       , Wwr         , Mm          , Gs^Ft       , Gs^Ft       , Hh          , Hh          , Gs^Ft       , Gs^Vht      , Wo          , Wo          
Wo          , Wo          , Ww          , Wo          , Ww          , Ww          , Wwf         , Wwf         , Ww          , Ww          , Mm          , Mm          , Hh          , Gs^Ft       , Ww          , Gs^Ft       , Gs^Ft       , Gs^Ft       , Hh          , Hh          , Gs^Ft       , Hh          , Ce          , Gs^Ft       , Gs^Ft       , Ww          , Wo          
Ww          , Ww          , Ww^Vm       , Wwf         , Wwr         , Gs^Ft       , Ww          , Ww          , Hh          , Hh          , Hh          , Ql          , Hh          , Hh          , Gs^Ft       , Ww          , Ds          , Gs^Ft       , Hh          , Hh          , Gs^Ft       , Ce          , 3 Ke        , Ww          , Ww          , Wo          , Wo          
Wo          , Wwr         , Wwf         , Ww          , Ww          , Ww          , Ww          , Hh          , Hh          , Hh          , Ww          , Ww          , Hh          , Ww          , Gs^Ft       , Ww          , Gs^Vht      , Gs          , Wwr         , Hh          , Hh          , Ce          , Ce          , Ww          , Ww          , Wo          , Wo          
Wo          , Wwf         , Ww          , Wwr         , Gs^Ft       , Ww          , Wwf         , Gs^Ft       , Ww          , Ww          , Ww          , Ww          , Ww          , Ww          , Ww          , Ww          , Hh          , Gs          , Gs^Ft       , Gs^Ft       , Gs^Ft       , Hh          , Gs^Ft       , Gs^Ft       , Ww          , Wo          , Wo          
Wo          , Ww          , Ww          , Ww          , Gs^Ft       , Wwf         , Ww          , Gs^Ft       , Ww          , Wo          , Wo          , Wo          , Wo          , Wo          , Ww          , Ww          , Hh          , Mm          , Hh          , Gs^Ft       , Ds          , Gs^Ft       , Gs^Ft       , Ww          , Wo          , Wo          , Wo          
Gs^Ft       , Gs^Ft       , Wwr         , Ww          , Wwf         , Wwf         , Ww          , Gs^Vht      , Ww          , Wo          , Wo          , Wo          , Wo          , Wo          , Wo          , Ww          , Ww          , Hh          , Hh          , Hh          , Ww          , Ww          , Gs^Vht      , Ww          , Wo          , Wo          , Wo          
Gs          , Gs^Vht      , Wwf         , Wwf         , Wo          , Wwf         , Ww          , Ww          , Wo          , Wo          , Wo          , Wo          , Wo          , Wo          , Wo          , Wo          , Wo          , Ww          , Ww          , Ww          , Wo          , Ww          , Ww          , Ww          , Wo          , Wo          , Wo          
Gs          , Gs          , Wwf         , Wwf         , Wo          , Wwf         , Wo          , Wo          , Wo          , Wo          , Wo          , Wo          , Wo          , Wo          , Wo          , Wo          , Wo          , Wo          , Wo          , Wo          , Ww          , Wo          , Wo          , Wo          , Wo          , Wo          , Wo          
