border_size=1
usage=map

       Wo,       Wo,       Wo,       Wo,       Wo,       Wo,       Wo,       Wo,       Wo,       Wo,       Ww,       Wo,       Wo,       Wo,       Ww,       Wo,       Ww,       Wo,       Wo,       Wo,       Wo,       Wo
       Wo,       Wo,       Wo,       Wo,       Wo,       Wo,       Wo,       Wo,       Wo,       Wo,       Ww,       Wo,       Wo,       Wo,       Ww,       Wo,       Ww,       Wo,       Wo,       Wo,       Wo,       Wo
       Wo,       Wo,       Wo,       Wo,       Wo,       Wo,       Wo,       Wo,       Ww,       Ww,       Gs,       Ww,       Ww,       Ww,       Gs,       Ww,       Gs,       Ww,       Wo,       Wo,       Wo,       Wo
       Wo,       Wo,       Wo,       Wo,       Ww,       Ww,       Ww,       Ww,       Gs,       Gs,       Gs,       Gs,       Gs,       Gs,   Gs^Vht,       Gs,       Ww,       Ww,       Wo,       Wo,       Wo,       Wo
       Wo,       Wo,       Wo,       Wo,       Ww,       Gs,       Gs,       Gs,       Gs,   Gs^Vht,       Rd,       Rd,       Rd,       Gs,       Gs,       Gs,       Ww,       Wo,       Wo,       Wo,       Wo,       Wo
       Wo,       Wo,       Wo,       Wo,   Ww^Bw\,       Gs,       Ch,       Ch,       Ch,       Rd,       Gs,       Gs,       Gs,       Rd,       Rd,       Gs,       Gs,       Ww,       Wo,       Wo,       Wo,       Wo
       Wo,       Wo,       Wo,       Wo,       Wo,   Gs^Vht,       Ch,     2 Kh,       Ch,       Gs,       Hh,       Hh,       Hh,       Gs,       Gs,       Rd,       Gs,       Ww,       Wo,       Wo,       Wo,       Wo
       Wo,       Wo,       Wo,       Wo,       Ww,       Ww,       Gs,       Ch,       Gs,       Gs,       Hh,       Mm,       Mm,       Hh,       Gs,       Rd,       Gs,       Ww,       Ww,       Wo,       Wo,       Wo
       Wo,       Wo,       Wo,       Ww,       Gs,       Ww,       Gs,       Rd,       Rd,       Gs,       Hh,       Mm,       Hh,       Hh,       Rd,       Rd,       Gs,       Gs,       Ww,       Wo,       Wo,       Wo
       Wo,       Wo,       Wo,       Ww,       Gs,       Gs,       Gs,   Gs^Vht,       Rd,       Gs,       Gs,       Hh,       Gs,       Hh,       Rd,       Gs,       Gs,       Gs,       Ww,       Ww,       Wo,       Wo
       Wo,       Wo,       Ww,       Ww,       Ds,       Gs,       Gs,       Gs,       Gs,       Rd,       Rd,       Gs,       Rd,   Gs^Vht,       Rd,       Rd,       Gs,       Gs,   Gs^Vht,       Ww,       Wo,       Wo
       Wo,       Wo,       Ww,       Ds,       Ds,       Ds,       Ds,       Gs,       Gs,       Gs,       Gs,       Rd,       Gs,       Rd,       Gs,       Rd,       Gs,       Gs,       Gs,       Ww,       Wo,       Wo
       Wo,       Wo,       Wo,       Ss,       Ss,       Ds,       Ds,       Ds,       Ds,   Gs^Vht,       Ds,       Gs,       Gs,       Gs,       Gs,       Rd,       Gs,       Gs,       Gs,       Ww,       Wo,       Wo
       Wo,       Wo,       Wo,       Ss,       Ss,   Ss^Vhs,       Ss,       Ds,       Ds,       Ds,       Ss,       Ds,       Ds,       Gs,       Ce,       Ce,       Ce,       Gs,       Ww,       Ww,       Wo,       Wo
       Wo,       Wo,       Ss,       Ds,       Ds,       Ds,       Ds,       Ss,       Ds,       Ss,       Ds,       Ds,       Ww,       Gs,       Ce,     1 Ke,       Ce,   Gs^Vht,   Ww^Bw\,       Ww,       Wo,       Wo
       Wo,       Wo,       Ss,       Ds,       Ss,       Ss,       Ss,       Ds,       Ss,       Ss,   Ss^Vhs,       Ss,       Wo,       Ww,       Gg,       Ce,       Gg,       Gg,       Ww,       Wo,       Wo,       Wo
       Wo,       Wo,       Ss,       Ds,       Ss,   Ss^Vhs,       Ss,       Ds,       Ds,       Ds,       Ds,       Ss,       Wo,       Ww,       Gg,       Gg,       Ww,       Ww,       Wo,       Wo,       Wo,       Wo
       Wo,       Wo,       Ss,       Ds,       Ds,       Ds,       Ds,       Ds,       Ss,       Ss,       Ss,       Ss,       Wo,       Ww,       Ww,       Gg,       Ww,       Ww,       Wo,       Wo,       Wo,       Wo
       Wo,       Wo,       Wo,       Ss,       Ss,       Ds,       Ds,       Ss,       Wo,       Wo,       Wo,       Wo,       Wo,       Wo,       Wo,       Ww,       Wo,       Wo,       Wo,       Wo,       Wo,       Wo
       Wo,       Wo,       Wo,       Wo,       Wo,       Ss,       Wo,       Wo,       Wo,       Wo,       Wo,       Wo,       Wo,       Wo,       Wo,       Wo,       Wo,       Wo,       Wo,       Wo,       Wo,       Wo
       Wo,       Wo,       Wo,       Wo,       Wo,       Wo,       Wo,       Wo,       Wo,       Wo,       Wo,       Wo,       Wo,       Wo,       Wo,       Wo,       Wo,       Wo,       Wo,       Wo,       Wo,       Wo
       Wo,       Wo,       Wo,       Wo,       Wo,       Wo,       Wo,       Wo,       Wo,       Wo,       Wo,       Wo,       Wo,       Wo,       Wo,       Wo,       Wo,       Wo,       Wo,       Wo,       Wo,       Wo
